5 10
|--------|
|.F.|..-.|
|..-|.@p.|
|.F....-.|
|--------|